1111111111111
1111111111111
1111111111111
1100011100011
1104011104011
1100044400011
1111111111111
0011111111100
0001111111000
0000111110000
